Joker 

Vykus 

local: Kraghemmer

Vykus me pediu para eu falar com a atendente de uma taver em Kraghemmer e pedir por uma "fada molhada".
Taverna: Fire brok in.



Alvinho -> Katu / gatinho
Kaun -> Ilikan / gigante
Eric -> Minerva / foguinho
Pedro -> Ieuguh / tartaruga
	Drunam / Riquinho

Annia -> filha da taverneira.
Gilda -> dona da taverna. campeão de luta livre.

fine -> amigo da Ilikan
carinha das bolças esta com a gigante -> Ilikan.
o pessoal conheço gato gigante -> Katu.

A cidade esta com uma difculdade de alguma coisa relacionado a doença.
Karuto Wakazari é o verdadeiro nome do Katu.

Ushra/Estrelinha -> pessoa que vamos fazer uma escolta.

fazenda de cogumelos é o local onde vamos escoltar ela.

Minerva, Ieuguh amigos da estrelinha.


Drunam / Riquinho -> Lorde de alguma familia


stilbem - local - cidade portuaria. grupo do dealer faz, muitas compras em stilbem
visnita - informante - grovaike

semias creitom - cara que anda com o FDP

irom kep - atual stedos tunder brench

House Bronzegrip: Mantém a serralharia Bronzegrip; principal casa para ferraria e metalurgia.[22]
House Glorendar: Mantém a lei e gerencia os Carvers.[22]
House Greyspine: Uma influente casa Kraghammer liderada por Gradim Greyspine, o antigo Ironkeeper de Kraghammer. Ele controla a pedreira Greyspine.[23]
House Thunderbrand: A casa mais importante em todas as coisas mágicas.[24]
House Zuurthom: A principal casa em arquitetura e alvenaria. Uma das cinco casas governantes de Kraghammer.[25]

mel de bizerra - palavra chave

valor das ervas - entre 70 - 80

--------------------------------------------------------------------------------------------------------

